11111111
10000011
10001001
10001011
11111111
