11111100
1100E111
10001001
1PC01011
11111111
