11111111
110PE111
100C1001
1P001011
11111111
