11111111
1100EP11
100C1001
1P001011
11111111
