11111111
10000011
100010E1
1P001011
11111111
