111111111111
100000C00011
10C0100000E1
1P0010100001
111111111111