11111111111111
1000000C000011
100C01000000E1
1P000101000001
10000101000001
10000101000001
11111111111111