1111111111111
100000C001C11
10C0100001E11
1P00101001001
1111111111111