11111111111111
10000000000011
100C00001000E1
1P000000100001
10000101000001
10000101000001
11111111111111