11111111111111
10000D0C000011
100C0D00D000E1
1P000000D00001
1000010D000001
10000101000001
11111111111111