11111111111111
10000001000011
100000001000E1
1P000000100001
10000101000000
10000101000001
11111111111111